 /‾‾‾‾‾‾‾‾‾‾‾‾‾‾‾‾‾‾‾‾‾‾‾‾‾‾‾‾‾‾‾‾‾‾‾‾‾‾‾‾‾‾‾‾‾‾‾‾‾‾‾‾‾‾‾‾‾‾‾‾‾‾‾‾‾‾‾\
|                                                                     |
|                                    Mines                            |
|                               ------/                               |
|         Farm                 /                                      |
|              \---------Pelican Town----------Joja Mart™             |
|             /                                                       |
|       Forest                                                        |
|                                                                     |
 \____________________________________________________________________/